$ $ $ $ $ $ $ $ $ $ $ $ $ $ $ # * # $ $ $ $ $ $ $ $ $ $ $ $ $ $ $
$ # # # # # # # # # # # # # # # $ # # # # # # # # # # # # # # # $
$ # ^ ^ ^ ^ ^ ^ ^ ^ ^ ^ ^ ^ ^ ^ ^ ^ ^ ^ ^ ^ ^ ^ ^ ^ ^ ^ ^ ^ ^ # $
$ # ^ # # # # # # # # # # # ^ # # # ^ # # # # # # # # # # # ^ # $
$ # ^ ^ @ # ^ ^ ^ ^ # ^ ^ ^ ^ ^ ^ ^ ^ ^ ^ ^ # ^ ^ ^ ^ # @ ^ ^ # $
$ # ^ # ^ # ^ # # ^ ^ ^ # $ $ $ $ $ $ $ # ^ ^ ^ # # ^ # ^ # ^ # $
$ # ^ # ^ ^ ^ # # ^ # ^ # $ # # $ # # $ # ^ # ^ # # ^ ^ ^ # ^ # $
$ # ^ # ^ # ^ ^ ^ ^ # ^ # $ # $ $ $ # $ # ^ # ^ ^ ^ ^ # ^ # ^ # $
$ # ^ ^ ^ # # # ^ # # ^ # $ # # # # # $ # ^ # # ^ # # # ^ ^ ^ # $
$ # ^ # ^ # # # ^ # ^ ^ ^ $ $ $ $ $ $ $ ^ ^ ^ # ^ # # # ^ # ^ # $
$ # ^ # ^ ^ ^ # ^ ^ ^ # ^ ^ ^ ^ ^ ^ ^ ^ ^ # ^ ^ ^ # ^ ^ ^ # ^ # $
$ # ^ # ^ # ^ # # # ^ # ^ # # # # # # # ^ # ^ # # # ^ # ^ # ^ # $
$ # ^ ^ ^ # ^ ^ ^ ^ ^ ^ ^ ^ ^ ^ $ ^ ^ ^ ^ ^ ^ ^ ^ ^ ^ # ^ ^ ^ # $
$ # ^ # # # ^ # # ^ # # ^ # # # ^ # # # ^ # # ^ # # ^ # # # ^ # $
$ # @ ^ ^ ^ ^ ^ ^ ^ ^ ^ ^ ^ ^ ^ ^ ^ ^ ^ ^ ^ ^ ^ ^ ^ ^ ^ ^ ^ @ # $
$ # # # # # # # # # # # # # # # $ # # # # # # # # # # # # # # # $
$ $ $ $ $ $ $ $ $ $ $ $ $ $ $ # * # $ $ $ $ $ $ $ $ $ $ $ $ $ $ $