$ $ $ $ $ $ $ $ $ $ $ $ $ $ $ $ $ $ $ $ $
$ # # # # # # # # # # # # # # # # # # # $
$ # ^ ^ ^ ^ ^ ^ ^ ^ # ^ ^ ^ ^ ^ ^ ^ ^ # $
$ # @ # # ^ # # # ^ # ^ # # # ^ # # @ # $
$ # ^ ^ ^ ^ ^ ^ ^ ^ ^ ^ ^ ^ ^ ^ ^ ^ ^ # $
$ # ^ # # ^ # ^ # # # # # ^ # ^ # # ^ # $
$ # ^ ^ ^ ^ # ^ ^ ^ # ^ ^ ^ # ^ ^ ^ ^ # $
$ # # # # ^ # # # $ # $ # # # ^ # # # # $
$ $ $ $ # ^ # $ $ $ $ $ $ $ # ^ # $ $ $ $
# # # # # ^ # $ # # $ # # $ # ^ # # # # #
* $ $ $ $ ^ $ $ # $ $ $ # $ $ ^ $ $ $ $ *
# # # # # ^ # $ # # # # # $ # ^ # # # # #
$ $ $ $ # ^ # $ $ $ $ $ $ $ # ^ # $ $ $ $
$ # # # # ^ # $ # # # # # $ # ^ # # # # $
$ # ^ ^ ^ ^ ^ ^ ^ ^ # ^ ^ ^ ^ ^ ^ ^ ^ # $
$ # ^ # # ^ # # # ^ # ^ # # # ^ # # ^ # $
$ # @ ^ # ^ ^ ^ ^ ^ $ ^ ^ ^ ^ ^ # ^ @ # $
$ # # ^ # ^ # ^ # # # # # ^ # ^ # ^ # # $
$ # ^ ^ ^ ^ # ^ ^ ^ # ^ ^ ^ # ^ ^ ^ ^ # $
$ # ^ # # # # # # ^ # ^ # # # # # # ^ # $
$ # ^ ^ ^ ^ ^ ^ ^ ^ ^ ^ ^ ^ ^ ^ ^ ^ ^ # $
$ # # # # # # # # # # # # # # # # # # # $